2 0 0 1 0 0 0 1 0 0
0 0 0 1 0 0 0 1 0 0
0 0 0 1 0 0 0 1 0 0
0 0 0 1 0 0 0 1 0 0
0 0 0 0 0 0 0 0 0 0
0 0 0 1 3 3 0 1 0 0
0 0 0 1 0 0 0 1 0 0
0 4 0 1 0 0 0 1 0 4
0 0 0 1 0 0 0 1 0 0
0 0 0 0 0 0 0 0 0 5
